[
  {
    "map": [
      [1,11],
      [1,1],
      [1,12],
      [1,0,0,1],
      [1,0,0,1],
      [1,1,1,1,2]
    ],
    "origin": {
      "x": 0,
      "y": 0,
      "z": 0
    },
    "orientation": "front"
  },
  {
    "map": [
      [0, 0, 0, 1, 0, 0, 0, 0, 0, 0],
      [0, 0, 0, 1, 0, 0, 0, 0, 0, 0],
      [0, 0, 0, 1, 0, 0, 0, 0, 0, 0],
      [0, 0, 0, 1, 0, 0, 0, 0, 0, 0],
      [0, 0, 0, 1, 0, 0, 0, 0, 0, 0],
      [0, 0, 0, 1, 0, 0, 0, 0, 0, 0],
      [0, 0, 0, 1, 0, 0, 0, 0, 0, 0],
      [0, 0, 0, 1, 0, 0, 0, 0, 0, 0],
      [0, 0, 0, 1, 0, 0, 0, 0, 0, 0],
      [0, 0, 0, 1, 8, 0, 0, 0, 0, 0],
      [0, 0, 0, 0, 0, 0, 0, 0, 0, 0],
      [0, 0, 0, 1, 10, 0, 0, 0, 0, 0]
    ],
    "origin": {
      "x": 6,
      "y": 0,
      "z": 0
    },
    "orientation": "right"
  },
  {
    "map": [
      [0, 0, 0, 1, 0, 0, 0, 0, 0, 0],
      [0, 0, 0, 1, 0, 0, 0, 0, 0, 0],
      [0, 0, 0, 1, 0, 0, 0, 0, 0, 0],
      [0, 0, 0, 1, 0, 0, 0, 0, 0, 0],
      [0, 0, 0, 1, 0, 0, 0, 0, 0, 0],
      [0, 0, 0, 1, 0, 0, 0, 0, 0, 0],
      [0, 0, 0, 1, 0, 0, 0, 0, 0, 0],
      [0, 0, 0, 1, 0, 0, 0, 0, 0, 0],
      [0, 0, 0, 1, 0, 0, 0, 0, 0, 0],
      [0, 0, 0, 1, 3, 0, 0, 0, 0, 0]
    ],
    "origin": {
      "x": 6,
      "y": 0,
      "z": -10
    },
    "orientation": "front"
  },
  {
    "map": [
      [0, 0, 0, 1, 0, 0, 0, 0, 0, 0],
      [0, 0, 0, 1, 0, 0, 0, 0, 0, 0],
      [0, 0, 0, 1, 0, 0, 0, 0, 0, 0],
      [0, 0, 0, 1, 0, 0, 0, 0, 0, 0],
      [0, 0, 0, 1, 0, 0, 0, 0, 0, 0],
      [0, 0, 0, 1, 0, 0, 0, 0, 0, 0],
      [0, 0, 0, 1, 0, 0, 0, 0, 0, 0],
      [0, 0, 0, 1, 0, 0, 0, 0, 0, 0],
      [0, 0, 0, 1, 0, 0, 0, 0, 0, 0],
      [0, 0, 0, 1, 7, 0, 0, 0, 0, 0]
    ],
    "origin": {
      "x": 16,
      "y": 0,
      "z": -10
    },
    "orientation": "left"
  },
  {
    "map": [
      [0, 0, 0, 1, 0, 0, 0, 0, 0, 0],
      [0, 0, 0, 1, 0, 0, 0, 0, 0, 0],
      [0, 0, 0, 1, 0, 0, 0, 0, 0, 0],
      [0, 0, 0, 1, 0, 0, 0, 0, 0, 0],
      [0, 0, 0, 1, 0, 0, 0, 0, 0, 0],
      [0, 0, 0, 1, 0, 0, 0, 0, 0, 0],
      [0, 0, 0, 1, 0, 0, 0, 0, 0, 0],
      [0, 0, 0, 1, 0, 0, 0, 0, 0, 0],
      [0, 0, 0, 1, 0, 0, 0, 0, 0, 0],
      [0, 0, 0, 1, 4, 0, 0, 0, 0, 0]
    ],
    "origin": {
      "x": 16,
      "y": 0,
      "z": 0
    },
    "orientation": "back"
  }
]
