[
  {
    "map": [
      [0, 0, 0, 11, 0, 0, 0, 0, 0, 0],
      [0, 0, 0, 1, 0, 0, 0, 0, 0, 0],
      [0, 0, 0, 1, 0, 0, 0, 0, 0, 0],
      [0, 0, 0, 1, 0, 0, 0, 0, 0, 0],
      [0, 0, 0, 1, 0, 0, 0, 0, 0, 0],
      [0, 0, 0, 1, 0, 0, 0, 0, 0, 0],
      [0, 0, 0, 1, 0, 0, 0, 0, 0, 0],
      [0, 0, 0, 1, 0, 0, 0, 0, 0, 0],
      [0, 0, 0, 1, 0, 0, 0, 0, 0, 0],
      [0, 0, 0, 1, 14, 0, 0, 0, 0, 0]
    ],
    "origin": {
      "x": 0,
      "y": 0,
      "z": 0
    },
    "orientation": "front"
  }
]
