[
  {
    "map": [
      [0, 0, 0, 11, 0, 0, 1, 13, 0, 0],
      [0, 0, 0, 1, 0, 0, 1, 0, 0, 0],
      [0, 0, 0, 21, 13, 0, 0, 0, 0, 0],
      [0, 0, 0, 1, 0, 0, 0, 0, 0, 0],
      [0, 0, 0, 1, 0, 0, 19, 0, 0, 0],
      [0, 0, 0, 1, 0, 15, 1, 16, 0, 0],
      [0, 0, 0, 1, 0, 0, 20, 0, 0, 0],
      [0, 0, 0, 22, 0, 17, 0, 0, 0, 0],
      [0, 0, 0, 1, 0, 18, 0, 0, 0, 0],
      [0, 0, 0, 1, 0, 18, 0, 0, 0, 0],
      [0, 0, 0, 1, 0, 18, 0, 0, 0, 0],
      [0, 0, 0, 1, 0, 18, 0, 0, 0, 0],
      [0, 0, 0, 1, 14, 0, 0, 0, 0, 0]
    ],
    "origin": {
      "x": 0,
      "y": 0,
      "z": 0
    },
    "orientation": "front"
  }
]
