[
  {
    "map": [
      [0, 0, 0, 1, 0, 0, 0, 0, 0, 0],
      [0, 0, 0, 1, 0, 0, 0, 0, 0, 0],
      [0, 0, 0, 1, 0, 0, 0, 0, 0, 0],
      [0, 0, 0, 1, 0, 0, 0, 0, 0, 0],
      [0, 0, 0, 1, 0, 0, 0, 0, 0, 0],
      [0, 0, 0, 1, 0, 0, 0, 0, 0, 0],
      [0, 0, 0, 1, 0, 0, 0, 0, 0, 0],
      [0, 0, 0, 1, 0, 0, 0, 0, 0, 0],
      [0, 0, 0, 1, 0, 0, 0, 0, 0, 0],
      [0, 0, 0, 2, 0, 0, 0, 0, 0, 0]
    ],
    "origin": {
      "x": 0,
      "y": 0,
      "z": 0
    },
    "orientation": "front"
  },
  {
    "map": [
      [0, 0, 0, 1, 0, 0, 0, 0, 0, 0],
      [0, 0, 0, 1, 0, 0, 0, 0, 0, 0],
      [0, 0, 0, 1, 0, 0, 0, 0, 0, 0],
      [0, 0, 0, 1, 0, 0, 0, 0, 0, 0],
      [0, 0, 0, 1, 0, 0, 0, 0, 0, 0],
      [0, 0, 0, 1, 0, 0, 0, 0, 0, 0],
      [0, 0, 0, 1, 0, 0, 0, 0, 0, 0],
      [0, 0, 0, 1, 0, 0, 0, 0, 0, 0],
      [0, 0, 0, 1, 0, 0, 0, 0, 0, 0],
      [0, 0, 0, 8, 0, 0, 0, 0, 0, 0]
    ],
    "origin": {
      "x": 10,
      "y": 0,
      "z": 0
    },
    "orientation": "right"
  },
  {
    "map": [
      [0, 0, 0, 1, 0, 0, 0, 0, 0, 0],
      [0, 0, 0, 1, 0, 0, 0, 0, 0, 0],
      [0, 0, 0, 1, 0, 0, 0, 0, 0, 0],
      [0, 0, 0, 1, 0, 0, 0, 0, 0, 0],
      [0, 0, 0, 1, 0, 0, 0, 0, 0, 0],
      [0, 0, 0, 1, 0, 0, 0, 0, 0, 0],
      [0, 0, 0, 1, 0, 0, 0, 0, 0, 0],
      [0, 0, 0, 1, 0, 0, 0, 0, 0, 0],
      [0, 0, 0, 1, 0, 0, 0, 0, 0, 0],
      [0, 0, 0, 4, 0, 0, 0, 0, 0, 0]
    ],
    "origin": {
      "x": 10,
      "y": 0,
      "z": -10
    },
    "orientation": "front"
  }
]
